1111211111111111222111
1112111111111112211111
1112221111111111122333
1231231231111111111111
0000000000000000000000
0000000000000000000000
0000000000000000000000
0000000000000000000000